NO textures/simonkraft/wet_sponge.xpm
SO textures/simonkraft/wet_sponge.xpm
WE textures/simonkraft/wet_sponge.xpm
EA textures/simonkraft/wet_sponge.xpm

F 164,169,20
C 153,204,255

111111111111111111111111111111111111111111111111111111111111111111111111111111111111111111111111111111111111111111111111111111111111111111111111111111111111111111111111111111111111111111111111111111111111111111111111111111111111111111111111111111111111111111111111111111111111111111111111111111111111111111111111111111111111111111111111111111111111111111111111111111111111111111111111111111111111111111111111111111111111111111111111111111111111111111111111111111111111111111111111111111111111111111111111111111111111111111111111111111111111111111
101000001000000000001101000001000000000001101000001000000000001101000001000000000001101000001000000000001101000001000000000001101000001000000000001101000001000000000001101000001000000000001101000001000000000001101000001000000000001101000001000000000001101000001000000000001101000001000000000001101000001000000000001101000001000000000001101000001000000000001101000001000000000001101000001000000000001101000001000000000001101000001000000000001101000001000000000001101000001000000000001101000001000000000001101000001000000000001101000001000000000001
101010101011111110001101010101011111110001101010101011111110001101010101011111110001101010101011111110001101010101011111110001101010101011111110001101010101011111110001101010101011111110001101010101011111110001101010101011111110001101010101011111110001101010101011111110001101010101011111110001101010101011111110001101010101011111110001101010101011111110001101010101011111110001101010101011111110001101010101011111110001101010101011111110001101010101011111110001101010101011111110001101010101011111110001101010101011111111111111111111111111111111
10001010001000001000110001010001000001000110001010001000001000110001010001000001000110001010001000001000110001010001000001000110001010001000001000110001010001000001000110001010001000001000110001010001000001000110001010001000001000110001010001000001000110001010001000001000110001010001000001000110001010001000001000110001010001000001000110001010001000001000110001010001000001000110001010001000001000110001010001000001000110001010001000001000110001010001000001000110001010001000001000110001010001000001000110001010001001
11111010111110101110111111010111110101110111111010111110101110111111010111110101110111111010111110101110111111010111110101110111111010111110101110111111010111110101110111111010111110101110111111010111110101110111111010111110101110111111010111110101110111111010111110101110111111010111110101110111111010111110101110111111010111110101110111111010111110101110111111010111110101110111111010111110101110111111010111110101110111111010111110101110111111010111110101110111111010111110101110111111010111110101110111111010111111
10000010100010100000110000010100010100000110000010100010100000110000010100010100000110000010100010100000110000010100010100000110000010100010100000110000010100010100000110000010100010100000110000010100010100000110000010100010100000110000010100010100000110000010100010100000110000010100010100000110000010100010100000110000010100010100000110000010100010100000110000010100010100000110000010100010100000110000010100010100000110000010100010100000110000010100010100000110000010100010100000110000010100010100000110000010100011
10111110101110111111110111110101110111111110111110101110111111110111110101110111111110111110101110111111110111110101110111111110111110101110111111110111110101110111111110111110101110111111110111110101110111111110111110101110111111110111110101110111111110111110101110111111110111110101110111111110111110101110111111110111110101110111111110111110101110111111110111110101110111111110111110101110111111110111110101110111111110111110101110111111110111110101110111111110111110101110111111110111110101110111111110111110101111
10100000101010000010110100000101010000010110100000101010000010110100000101010000010110100000101010000010110100000101010000010110100000101010000010110100000101010000010110100000101010000010110100000101010000010110100000101010000010110100000101010000010110100000101010000010110100000101010000010110100000101010000010110100000101010000010110100000101010000010110100000101010000010110100000101010000010110100000101010000010110100000101010000010110100000101010000010110100000101010000010110100000101010000010110100000101011
10101111101011111010110101111101011111010110101111101011111010110101111101011111010110101111101011111010110101111101011111010110101111101011111010110101111101011111010110101111101011111010110101111101011111010110101111101011111010110101111101011111010110101111101011111010110101111101011111010110101111101011111010110101111101011111010110101111101011111010110101111101011111010110101111101011111010110101111101011111010110101111101011111010110101111101011111010110101111101011111010110101111101011111010110101111101011
10101000101010001010110101000101010001010110101000101010001010110101000101010001010110101000101010001010110101000101010001010110101000101010001010110101000101010001010110101000101010001010110101000101010001010110101000101010001010110101000101010001010110101000101010001010110101000101010001010110101000101010001010110101000101010001010110101000101010001010110101000101010001010110101000101010001010110101000101010001010110101000101010001010110101000101010001010110101000101010001010110101000101010001010110101000101011
10111010101010101010110111010101010101010110111010101010101010110111010101010101010110111010101010101010110111010101010101010110111010101010101010110111010101010101010110111010101010101010110111010101010101010110111010101010101010110111010101010101010110111010101010101010110111010101010101010110111010101010101010110111010101010101010110111010101010101010110111010101010101010110111010101010101010110111010101010101010110111010101010101010110111010101010101010110111010101010101010110111010101010101010110111010101011
10000010101000101000110000010101000101000110000010101000101000110000010101000101000110000010101000101000110000010101000101000110000010101000101000110000010101000101000110000010101000101000110000010101000101000110000010101000101000110000010101000101000110000010101000101000110000010101000101000110000010101000101000110000010101000101000110000010101000101000110000010101000101000110000010101000101000110000010101000101000110000010101000101000110000010101000101000110000010101000101000110000010101000101000110000010101001
11111110101111101110111111110101111101110111111110101111101110111111110101111101110111111110101111101110111111110101111101110111111110101111101110111111110101111101110111111110101111101110111111110101111101110111111110101111101110111111110101111101110111111110101111101110111111110101111101110111111110101111101110111111110101111101110111111110101111101110111111110101111101110111111110101111101110111111110101111101110111111110101111101110111111110101111101110111111110101111101110111111110101111101110111111110101111
10000010100010001000110000010100010001000110000010100010001000110000010100010001000110000010100010001000110000010100010001000110000010100010001000110000010100010001000110000010100010001000110000010100010001000110000010100010001000110000010100010001000110000010100010001000110000010100010001000110000010100010001000110000010100010001000110000010100010001000110000010100010001000110000010100010001000110000010100010001000110000010100010001000110000010100010001000110000010100010001000110000010100010001000110000010100011
10111010111010111011110111010111010111011110111010111010111011110111010111010111011110111010111010111011110111010111010111011110111010111010111011110111010111010111011110111010111010111011110111010111010111011110111010111010111011110111010111010111011110111010111010111011110111010111010111011110111010111010111011110111010111010111011110111010111010111011110111010111010111011110111010111010111011110111010111010111011110111010111010111011110111010111010111011110111010111010111011110111010111010111011110111010111011
10100010000010001010110100010000010001010110100010000010001010110100010000010001010110100010000010001010110100010000010001010110100010000010001010110100010000010001010110100010000010001010110100010000010001010110100010000010001010110100010000010001010110100010000010001010110100010000010001010110100010000010001010110100010000010001010110100010000010001010110100010000010001010110100010000010001010110100010000010001010110100010000010001010110100010000010001010110100010000010001010110100010000010001010110100010000011
10101111111111101010110101111111111101010110101111111111101010110101111111111101010110101111111111101010110101111111111101010110101111111111101010110101111111111101010110101111111111101010110101111111111101010110101111111111101010110101111111111101010110101111111111101010110101111111111101010110101111111111101010110101111111111101010110101111111111101010110101111111111101010110101111111111101010110101111111111101010110101111111111101010110101111111111101010110101111111111101010110101111111111101010110101111111111
10001000000000001000110001000000000001000110001000000000001000110001000000000001000110001000000000001000110001000000000001000110001000000000001000110001000000000001000110001000000000001000110001000000000001000110001000000000001000110001000000000001000110001000000000001000110001000000000001000110001000000000001000110001000000000001000110001000000000001000110001000000000001000110001000000000001000110001000000000001000110001000000000001000110001000000000001000110001000000000001000110001000000000001000110001000000001
10101011101111111110110101011101111111110110101011101111111110110101011101111111110110101011101111111110110101011101111111110110101011101111111110110101011101111111110110101011101111111110110101011101111111110110101011101111111110110101011101111111110110101011101111111110110101011101111111110110101011101111111110110101011101111111110110101011101111111110110101011101111111110110101011101111111110110101011101111111110110101011101111111110110101011101111111110110101011101111111110110101011101111111110110101011101111
1N100000100000000000110100000100000000000110100000100000000000110100000100000000000110100000100000000000110100000100000000000110100000100000000000110100000100000000000110100000100000000000110100000100000000000110100000100000000000110100000100000000000110100000100000000000110100000100000000000110100000100000000000110100000100000000000110100000100000000000110100000100000000000110100000100000000000110100000100000000000110100000100000000000110100000100000000000110100000100000000000110100000100000000000110100000100001
11111111111111111111111111111111111111111111111111111111111111111111111111111111111111111111111111111111111111111111111111111111111111111111111111111111111111111111111111111111111111111111111111111111111111111111111111111111111111111111111111111111111111111111111111111111111111111111111111111111111111111111111111111111111111111111111111111111111111111111111111111111111111111111111111111111111111111111111111111111111111111111111111111111111111111111111111111111111111111111111111111111111111111111111111111111111111

